#######################
#**********#**********#
#@###*####*#*####*###@#
#*###*####*#*####*###*#
#*********************#
#*###*#*#######*#*###*#
#*****#*#######*#*****#
#*###*#****#****#*###*#
#*###*####.#.####*###*#
#*###*#.........#*###*#
#*###*#.#######.#*###*#
#*...*..#=====#..*...*#
#*###*#.#######.#*###*#
#*###*#.........#*###*#
#*###*#.#######.#*###*#
#*###*#.#######.#*###*#
#**********#**********#
#*###*####*#*####*###*#
#@**#******.******#**@#
###*#*#*#######*#*#*###
#*****#****#****#*****#
#*########*#*########*#
#*########*#*########*#
#*********************#
#######################



