#######################
#**********#**********#
#@###*####*#*####*###@#
#*###*####*#*####*###*#
#*********************#
#*###*#*#######*#*###*#
#*****#*#######*#*****#
#####*#****#****#*#####
#####*####.#.####*#####
#####*#.........#*#####
#####*#.###.###.#*#####
.....*..#GG.GG#..*.....
#####*#.#######.#*#####
#####*#.........#*#####
#####*#.#######.#*#####
#####*#.#######.#*#####
#**********#**********#
#*###*####*#*####*###*#
#@**#******P******#**@#
###*#*#*#######*#*#*###
#*****#****#****#*****#
#*########*#*########*#
#*########*#*########*#
#*********************#
#######################



